NO ./maps/42.cub

F 22.22.22
NO ./maps/42.cub

NO ./maps/42.cub
1111111
1111111
100S001
1111111