a a


  11111111111111
11110000010S11111111
   11111111111101
111111111111111111