NO ./maps/42.cub
SO ./maps/42.cub
EA ./maps/42.cub
WE ./maps/42.cub

F 0,1,2
C 3,4,5

1111111
1111111
100S001
1111111