NO ./maps/42.cub
SO ./maps/42.cub
EA ./maps/42.cub
WE ./maps/42.cub
F 22,22,22
C 22,22,22
1111111
1111111
100S001
1111111